#############
########____#
########_##X#
########_##_#
########_XXX#
###_X##___P_#
##__P##_#X_##
#X___P__P_###
#___###P#PPS#
#######_____#
#############