#########
##__X___#
##P#X#P_#
#__TX_P_#
#_PPX####
###_XP_##
###_XP_##
###SX__##
#########
