########
##X__###
##_#P###
#_P_P__#
#_XX___#
##S_U###
########