###########
#S_G#######
####___X###
#__PP#__X_#
#_PP_#_P#X#
#_P____P__#
#_#####X#_#
#____XXX__#
###########
